11111111111111111111
10E0000C000000000001
1000000P111111111111
11111111111111111111
