1111111111111111111111111111111111
10000000E00000F0000000F00000000001
1010010100100000101001000000010101
1010010010101010001001000000010101
1P00000F0000000F00000C0000000F0011
1111111111111111111111111111111111
