1111111111111111111
10E0000C00000000001
1000000P11111111111
1111111111111111111
