1111111111111111111111111111111111
1E000000000000F0000000F00000000001
1010010100100000101001000000010101
1000010010101010001001000000010101
1P00F000000000F00000C00000000F0011
1111111111111111111111111111111111
